lgdm:sourceTag	http://linkedgeodata.org/ontology/Bakery/key/shop/value/bakery
rdfs:subClassOf	http://linkedgeodata.org/ontology/Shop
rdfs:label:br	Baraerezh
rdfs:label:vi	Tiệm Bánh
rdfs:label:en-GB	Bakery
rdfs:label:ca	Fleca
rdfs:label:fi	Leipomo
rdfs:label:hsb	Pjekarnja
rdfs:label:af	Bakkery
rdfs:label:pl	Piekarnia
rdfs:label:ps	بټيارۍ
rdfs:label:ia	Paneteria
rdfs:label:no	Bakeri
rdfs:label:ka	საცხობი
rdfs:label:zh-Hant	麵包店
rdfs:label:lv	Maiznīca
rdfs:label:fa	نانوایی
rdfs:label:ar	مخبز
rdfs:label:arz	مخبز
rdfs:label:nl	Bakkerij
rdfs:label:sr-EL	Pekara
rdfs:label:hr	Pekara
rdfs:label:de	Bäckerei
rdfs:label:lb	Bäckerei
rdfs:label:ru	Булочная
rdfs:label:is	Bakaríið
rdfs:label:ku-Latn	Firrin
rdfs:label:da	Bager
rdfs:label:sl	Pekarna
rdfs:label:eu	Okindegi
rdfs:label:it	Panetteria
rdfs:label:aln	Dyqan buke
rdfs:label:sq	Dyqan buke
rdfs:label:zh-Hans	面包店
rdfs:label:sv	Bageri
rdfs:label:nds	Bäckeree
rdfs:label:he	מאפייה
rdfs:label:ja	パン屋
rdfs:label:sk	Pekáreň
rdfs:label:pt	Padaria
rdfs:label:pt-BR	Padaria
rdfs:label:el	Φούρνος
rdfs:label:be-tarask	Пякарня
rdfs:label:uk	Хліб
rdfs:label:tl	Panaderya
rdfs:label:fur	Pancôr
rdfs:label:lt	Kepykla
rdfs:label:gl	Panadaría
rdfs:label:dsb	Pjakarnja
rdfs:label:cs	Pekařství
rdfs:label:ast	Panadería
rdfs:label:es	Panadería
rdfs:label:tr	Fırın
rdfs:label:hu	Pékség
rdfs:label:fr	Boulangerie
rdfs:label:mk	Пекара
rdfs:label:sr-EC	Пекара
url	http://linkedgeodata.org/ontology/Bakery
label	Bakery
