lgdm:sourceTag	http://linkedgeodata.org/ontology/Embassy/key/amenity/value/embassy
rdfs:subClassOf	http://linkedgeodata.org/ontology/Amenity
rdfs:label:ca	Ambaixada
rdfs:label:hr	Veleposlanstvo
rdfs:label:pt-BR	Embaixada
rdfs:label:gl	Embaixada
rdfs:label:it	Ambasciata
rdfs:label:et	Saatkond
rdfs:label:vi	Tòa Đại sứ
rdfs:label:he	שגרירות
rdfs:label:dsb	Wjelikopósłaństwo
rdfs:label:eu	Enbaxada
rdfs:label:ru	Посольство
rdfs:label:tr	Elçilik
rdfs:label:myv	Кучолкс кудо
rdfs:label:sl	Veleposlaništvo
rdfs:label:ast	Embaxada
rdfs:label:mk	Амбасада
rdfs:label:uk	Амбасада
rdfs:label:fi	Lähetystö
rdfs:label:be-tarask	Амбасада
rdfs:label:sr-EC	Амбасада
rdfs:label:ms	Kedutaan
rdfs:label:bn	দূতাবাস
rdfs:label:de	Botschaft
rdfs:label:es	Embajada
rdfs:label:hu	Nagykövetség
rdfs:label:is	Sendiráðið
rdfs:label:cs	Velvyslanectví
rdfs:label:nds	Baadschop
rdfs:label:ka	საელჩო
rdfs:label:ar	سفارة
rdfs:label:arz	سفارة
rdfs:label:zh-Hant	大使館
rdfs:label:ja	大使館
rdfs:label:hsb	Wulkopósłanstwo
rdfs:label:zh-Hans	大使馆
rdfs:label:lv	Vēstniecība
rdfs:label:sr-EL	Ambasada
rdfs:label:pl	Ambasada
rdfs:label:sq	Ambasada
rdfs:label:aln	Ambasada
rdfs:label:lt	Ambasada
rdfs:label:sk	Veľvyslanectvo
rdfs:label:sv	Ambassad
rdfs:label:tl	Embahada
rdfs:label:el	Πρεσβεία
rdfs:label:fa	سفارت
rdfs:label:ps	سفارت
rdfs:label:br	Kannati
rdfs:label:nl	Ambassade
rdfs:label:fr	Ambassade
rdfs:label:fur	Ambassade
rdfs:label:no	Ambassade
rdfs:label:af	Ambassade
rdfs:label:en-GB	Embassy
rdfs:label:lb	Ambassade
rdfs:label:da	Ambassade
rdfs:label:ia	Ambassada
url	http://linkedgeodata.org/ontology/Embassy
label	Embassy
