lgdm:sourceTag	http://linkedgeodata.org/ontology/Fountain/key/amenity/value/fountain
rdfs:subClassOf	http://linkedgeodata.org/ontology/Amenity
rdfs:label:ja	噴水
rdfs:label:da	Springvand
rdfs:label:uk	Фонтан
rdfs:label:de	Springbrunnen
rdfs:label:nl	Fontein
rdfs:label:af	Fontein
rdfs:label:ca	Font
rdfs:label:lt	Fontanas
rdfs:label:tl	Bukal
rdfs:label:fr	Fontaine
rdfs:label:arz	نافورة
rdfs:label:ar	نافورة
rdfs:label:aln	Burim
rdfs:label:ms	Air Pancutan
rdfs:label:sv	Fontän
rdfs:label:eu	Iturri
rdfs:label:br	Feunteun
rdfs:label:et	Purskkaev
rdfs:label:dsb	Studnja
rdfs:label:hsb	Studnja
rdfs:label:no	Fontene
rdfs:label:pl	Fontanna
rdfs:label:hu	Szökőkút
rdfs:label:mk	Фонтана
rdfs:label:sr-EC	Фонтана
rdfs:label:en-GB	Fountain
rdfs:label:vi	Vòi nước
rdfs:label:hr	Fontana
rdfs:label:sr-EL	Fontana
rdfs:label:it	Fontana
rdfs:label:ia	Fontana
rdfs:label:pt-BR	Fonte
rdfs:label:gl	Fonte
rdfs:label:ast	Fonte
rdfs:label:pt	Fonte
rdfs:label:lb	Sprangbur
rdfs:label:sk	Fontána
rdfs:label:ka	შადრევანი
rdfs:label:lv	Strūklaka
rdfs:label:cs	Fontána
rdfs:label:ru	фонтан
rdfs:label:sl	Vodomet
rdfs:label:el	Συντριβάνι
rdfs:label:zh-Hans	喷泉
rdfs:label:fi	Lähde
rdfs:label:es	Fuente
rdfs:label:is	Gosbrunnur
rdfs:label:nds	Fontään
rdfs:label:fur	Fontane
rdfs:label:be-tarask	Фантан
rdfs:label:he	מזרקה
rdfs:label:tr	Fıskiye
url	http://linkedgeodata.org/ontology/Fountain
label	Fountain
