lgdm:sourceTag	http://linkedgeodata.org/ontology/Hospital/key/amenity/value/hospital
rdfs:subClassOf	http://linkedgeodata.org/ontology/Amenity
rdfs:label:lv	Slimnīca
rdfs:label:vi	Bệnh viện
rdfs:label:nl	Ziekenhuis
rdfs:label:uk	Лікарня
rdfs:label:br	Ospital
rdfs:label:lb	Klinik
rdfs:label:tl	Ospital
rdfs:label:ca	Hospital
rdfs:label:hu	Kórház
rdfs:label:ia	Hospital
rdfs:label:pt-BR	Hospital
rdfs:label:ast	Hospital
rdfs:label:gl	Hospital
rdfs:label:ms	Hospital
rdfs:label:es	Hospital
rdfs:label:zh-Hant	醫院
rdfs:label:de	Krankenhaus
rdfs:label:cs	Nemocnice
rdfs:label:en-GB	Hospital
rdfs:label:ru	Госпиталь
rdfs:label:pt	Hospital
rdfs:label:nds	Krankenhuus
rdfs:label:sv	Sjukhus
rdfs:label:fr	Hôpital
rdfs:label:is	Sjúkrahúsið
rdfs:label:lt	Ligoninė
rdfs:label:ka	საავადმყოფო
rdfs:label:da	Sygehus
rdfs:label:tr	Hastane
rdfs:label:sk	Nemocnica
rdfs:label:aln	Spital
rdfs:label:ps	روغتون
rdfs:label:ja	病院
rdfs:label:be-tarask	Шпіталь
rdfs:label:af	Hospitaal
rdfs:label:it	Ospedale
rdfs:label:fa	بیمارستان
rdfs:label:sr-EL	Bolnica
rdfs:label:hr	Bolnica
rdfs:label:eu	Ospitalea
rdfs:label:sl	Bolnišnica
rdfs:label:arz	مستشفى
rdfs:label:sr-EC	Болница
rdfs:label:mk	Болница
rdfs:label:ar	مستشفى
rdfs:label:no	Sykehus
rdfs:label:el	Νοσοκομείο
rdfs:label:dsb	Chórownja
rdfs:label:fi	Sairaala
rdfs:label:zh-Hans	医院
rdfs:label:he	בית חולים
rdfs:label:pl	Szpital
rdfs:label:hsb	Chorownja
rdfs:label:te	ఆసుపత్రి
rdfs:label:et	Haigla
rdfs:label:fur	Ospedâl
url	http://linkedgeodata.org/ontology/Hospital
label	Hospital
