lgdm:sourceTag	http://linkedgeodata.org/ontology/Library/key/amenity/value/library
rdfs:subClassOf	http://linkedgeodata.org/ontology/Amenity
rdfs:label:aln	Bibliotekë
rdfs:label:fr	Bibliothèque
rdfs:label:nds	Bökeree
rdfs:label:hsb	Knihownja
rdfs:label:sk	Knižnica
rdfs:label:ka	ბიბლიოთეკა
rdfs:label:fi	Kirjasto
rdfs:label:dsb	Knigłownja
rdfs:label:is	Bókasafnið
rdfs:label:ps	کتابتون
rdfs:label:el	Βιβλιοθήκη
rdfs:label:ar	مكتبة
rdfs:label:arz	مكتبة
rdfs:label:sl	Knjižnica
rdfs:label:hr	Knjižnica
rdfs:label:sr-EC	Библиотека
rdfs:label:mk	Библиотека
rdfs:label:ru	Библиотека
rdfs:label:ia	Bibliotheca
rdfs:label:ja	図書館
rdfs:label:cs	Knihovna
rdfs:label:lv	Bibliotēka
rdfs:label:de	Bücherei
rdfs:label:bn	পাঠাগার
rdfs:label:lt	Biblioteka
rdfs:label:sr-EL	Biblioteka
rdfs:label:pl	Biblioteka
rdfs:label:tr	Kütüphane
rdfs:label:he	ספרייה
rdfs:label:zh-Hant	圖書館
rdfs:label:ca	Biblioteca
rdfs:label:pt	Biblioteca
rdfs:label:uk	Бібліотека
rdfs:label:te	గ్రంథాలయం
rdfs:label:pt-BR	Biblioteca
rdfs:label:fa	کتابخانه
rdfs:label:ast	Biblioteca
rdfs:label:lb	Bibliothéik
rdfs:label:es	Biblioteca
rdfs:label:gl	Biblioteca
rdfs:label:it	Biblioteca
rdfs:label:et	Raamatukogu
rdfs:label:da	Bibliotek
rdfs:label:no	Bibliotek
rdfs:label:sv	Bibliotek
rdfs:label:af	Biblioteek
rdfs:label:vi	Thư viện
rdfs:label:en-GB	Library
rdfs:label:eu	Liburutegia
rdfs:label:nl	Bibliotheek
rdfs:label:tl	Aklatan
rdfs:label:br	Levraoueg
rdfs:label:ms	Perpustakaan
rdfs:label:zh-Hans	图书馆
rdfs:label:hu	Könyvtár
rdfs:label:be-tarask	Бібліятэка
rdfs:label:fur	Biblioteche
url	http://linkedgeodata.org/ontology/Library
label	Library
