lgdm:sourceTag	http://linkedgeodata.org/ontology/Pharmacy/key/shop/value/pharmacy
rdfs:subClassOf	http://linkedgeodata.org/ontology/Shop
rdfs:label:mk	Аптека
rdfs:label:uk	Аптека
rdfs:label:ru	Аптека
rdfs:label:ms	Farmasi
rdfs:label:sr-EC	Апотека
rdfs:label:hr	Ljekarna
rdfs:label:ca	Farmàcia
rdfs:label:ia	Pharmacia
rdfs:label:lt	Vaistinė
rdfs:label:ps	درملتون
rdfs:label:sr-EL	Apoteka
rdfs:label:bn	ঔষধালয়
rdfs:label:cs	Lékárna
rdfs:label:zh-Hant	藥房
rdfs:label:tr	Eczane
rdfs:label:tl	Botika
rdfs:label:ja	薬局
rdfs:label:br	Apotikerezh
rdfs:label:af	Apteek
rdfs:label:et	Apteek
rdfs:label:gl	Farmacia
rdfs:label:es	Farmacia
rdfs:label:it	Farmacia
rdfs:label:ast	Farmacia
rdfs:label:myv	Оптека
rdfs:label:nds	Avtheek
rdfs:label:fa	داروخانه
rdfs:label:da	Apotek
rdfs:label:fr	Pharmacie
rdfs:label:no	Apotek
rdfs:label:sv	Apotek
rdfs:label:zh-Hans	药房
rdfs:label:ku-Latn	Îlacxane
rdfs:label:hu	Gyógyszertár
rdfs:label:sl	Lekarna
rdfs:label:lv	Aptieka
rdfs:label:sk	lekáreň
rdfs:label:dsb	Aptejka
rdfs:label:aln	Barnatore
rdfs:label:nl	Apotheek
rdfs:label:fur	Farmacie
rdfs:label:pl	Apteka
rdfs:label:en-GB	Pharmacy
rdfs:label:ka	აფთიაქი
rdfs:label:he	בית מרקחת
rdfs:label:be-tarask	Аптэка
rdfs:label:arz	صيدلية
rdfs:label:pt-BR	Farmácia
rdfs:label:pt	Farmácia
rdfs:label:ar	صيدلية
rdfs:label:fi	Apteekki
rdfs:label:hsb	Lěkarnja
rdfs:label:lb	Apdikt
rdfs:label:eu	Farmazia
rdfs:label:vi	Nhà thuốc
rdfs:label:de	Apotheke
url	http://linkedgeodata.org/ontology/Pharmacy
label	Pharmacy
