lgdm:sourceTag	http://linkedgeodata.org/ontology/Pub/key/amenity/value/pub
rdfs:subClassOf	http://linkedgeodata.org/ontology/Amenity
rdfs:label:ar	حانة
rdfs:label:arz	حانة
rdfs:label:hu	Kocsma
rdfs:label:sk	Krčma
rdfs:label:vi	Quán rượu
rdfs:label:el	Παμπ
rdfs:label:sr-EL	Pab
rdfs:label:ms	Pab
rdfs:label:aln	Pijetore
rdfs:label:dsb	Kjarcma
rdfs:label:he	פאב
rdfs:label:be-tarask	Шынок
rdfs:label:zh-Hans	酒馆
rdfs:label:mk	Пивница
rdfs:label:ru	Паб
rdfs:label:sr-EC	Паб
rdfs:label:uk	Паб
rdfs:label:fr	Bar
rdfs:label:is	Pöbbinn
rdfs:label:af	Kroeg
rdfs:label:de	Kneipe
rdfs:label:tr	Birahane
rdfs:label:lb	Bistro
rdfs:label:ja	パブ（立ち吞み屋）
rdfs:label:hsb	Korčma
rdfs:label:sl	Pivnica
rdfs:label:br	Tavarn
rdfs:label:nds	Kroog
rdfs:label:fa	میخانه
rdfs:label:lv	Krogs
rdfs:label:ia	Taverna
rdfs:label:cs	Hospoda
rdfs:label:nl	Café
rdfs:label:ka	პაბი
rdfs:label:lt	Aludė
rdfs:label:da	Pub
rdfs:label:ca	Pub
rdfs:label:fur	Pub
rdfs:label:es	Pub
rdfs:label:en-GB	Pub
rdfs:label:ast	Pub
rdfs:label:pt-BR	Pub
rdfs:label:pl	Pub
rdfs:label:hr	Pub
rdfs:label:no	Pub
rdfs:label:sv	Pub
rdfs:label:gl	Pub
rdfs:label:fi	Pubi
rdfs:label:et	Pubi
rdfs:label:it	Pub
rdfs:label:tl	Pangmadlang Bahay
url	http://linkedgeodata.org/ontology/Pub
label	Pub
