lgdm:sourceTag	http://linkedgeodata.org/ontology/Ruins/key/historic/value/ruins
rdfs:subClassOf	http://linkedgeodata.org/ontology/HistoricThing
rdfs:label:he	הריסות
rdfs:label:mk	Рушевини
rdfs:label:en-GB	Ruins
rdfs:label:sr-EC	Рушевине
rdfs:label:zh-Hans	遗迹
rdfs:label:af	Ruïnes
rdfs:label:ca	Ruïnes
rdfs:label:ru	Развалины
rdfs:label:sr-EL	Ruševine
rdfs:label:sl	Ruševine
rdfs:label:hr	Ruševine
rdfs:label:it	Rovine
rdfs:label:cs	Zřícenina
rdfs:label:be-tarask	Руіны
rdfs:label:tr	Harabe
rdfs:label:ms	Puing
rdfs:label:ja	廃墟
rdfs:label:da	Ruin
rdfs:label:sv	Ruin
rdfs:label:lt	Griuvėsiai
rdfs:label:no	Ruiner
rdfs:label:lv	Drupas
rdfs:label:vi	Tàn tích
rdfs:label:pt-BR	Ruínas
rdfs:label:pt	Ruínas
rdfs:label:gl	Ruínas
rdfs:label:et	Varemed
rdfs:label:de	Ruine
rdfs:label:aln	Gërmadhe
rdfs:label:nl	Ruïne
rdfs:label:pl	Ruiny
rdfs:label:dsb	Ruiny
rdfs:label:fi	Rauniot
rdfs:label:ka	ნანგრევები
rdfs:label:hsb	Rozpadanki
rdfs:label:ia	Ruinas
rdfs:label:es	Ruinas
rdfs:label:te	శిథిలాలు
rdfs:label:arz	أطلال
rdfs:label:ar	أطلال
rdfs:label:uk	Руїни
rdfs:label:ast	Ruines
rdfs:label:fr	Ruines
rdfs:label:hu	Rom
rdfs:label:tl	Mga Guho
rdfs:label:nds	Ruinen
rdfs:label:lb	Ruinen
rdfs:label:br	Dismantroù
rdfs:label:sk	Ruina
url	http://linkedgeodata.org/ontology/Ruins
label	Ruins
