lgdm:sourceTag	http://linkedgeodata.org/ontology/Toilets/key/amenity/value/toilets
rdfs:subClassOf	http://linkedgeodata.org/ontology/Amenity
rdfs:label:ar	مراحيض
rdfs:label:arz	مراحيض
rdfs:label:ka	ტუალეტი
rdfs:label:vi	Vệ sinh
rdfs:label:ps	چړچوبي
rdfs:label:uk	Туалет
rdfs:label:ru	Туалет
rdfs:label:be-tarask	Туалет
rdfs:label:hsb	Nuzniki
rdfs:label:no	Toaletter
rdfs:label:sv	Toaletter
rdfs:label:af	Toilette
rdfs:label:el	Τουαλέτες
rdfs:label:et	WC
rdfs:label:sk	WC
rdfs:label:hr	WC
rdfs:label:de	WC
rdfs:label:hu	WC
rdfs:label:fi	WC
rdfs:label:tr	Tuvalet
rdfs:label:en-GB	Toilets
rdfs:label:lt	Tualetas
rdfs:label:fa	توالت
rdfs:label:ms	Tandas
rdfs:label:br	Privezioù
rdfs:label:sr-EL	Toaleti
rdfs:label:ja	トイレ
rdfs:label:it	Bagni pubblici
rdfs:label:gl	Aseos
rdfs:label:es	Aseos
rdfs:label:mk	Тоалет
rdfs:label:ia	Toilettes
rdfs:label:fr	Toilettes
rdfs:label:sl	Stranišča
rdfs:label:cs	Toalety
rdfs:label:pt-BR	Banheiros
rdfs:label:dsb	Toalety
rdfs:label:da	Toiletter
rdfs:label:sr-EC	Тоалети
rdfs:label:tl	Mga banyo
rdfs:label:ast	Servicios
rdfs:label:ca	Banys
rdfs:label:eu	Komunak
rdfs:label:zh-Hant	洗手間
rdfs:label:aln	Tualet
rdfs:label:te	మరుగుదొడ్లు
rdfs:label:he	שירותים
rdfs:label:pl	Toaleta publiczna
rdfs:label:nl	Toiletten
rdfs:label:nds	Toiletten
rdfs:label:lb	Toiletten
rdfs:label:lv	Tualetes
rdfs:label:zh-Hans	洗手间
rdfs:label:rue	Тоалета
url	http://linkedgeodata.org/ontology/Toilets
label	Toilets
